NO ./img/greystone.xpm
WE ./img/mossy.xpm
SO ./img/greystone.xpm
EA ./img/mossy.xpm

C 45, 45, 45
F 45, 45, 45

                            1111111111111
    111111                  1000000000001
    100001      11111111111110000000000011111
    100001      10000000000010000000000010001
    1000001     10000000000000000000000000001
    1000001     10001111111110000000000010001
    11111111111 10001       10000000000011111
    10000000001 1000111      111110111111
    1000000000111000001         10001
    1000000000100000001         10001
     1000000000000000001         10001
     1000000000111111111         10001
     10000000001            111111000111
1111110000000001            100000000001
100011111101111             100111000111
1000110010001               1001110001
1000100010001               1001110001
1101100010001               1111110001
1000111110001                    10001
1000111010001                    11011                11111111
1000011011011111           111111000001111111         10000001
1000011000000001           100000000000000011         10000001
1000000000000001           10000000000000001111111111110000001
1000001000000001           10000000000000000100000000010000001
1000011000000001           10000000000000000000000000000000001
1000011000000001           10000000000000000100000000010000001
1000011000000001           10000000000000001111000011110000001
10000111111011111          100000000000000011111001   10000001
10000111110001             11111100000111111   1001   10000001
10000111110001                  111011         1001   11111111
10000100010001                   10001         1001
10000000010001                   10001         1001
10000100010001                   10001         100111111111111
10000111110001                   10001         100010000000001
10000111110001111111111111       10001         100000000000001
1000000000000000001000000111     10001         100010000000001
1000000000000000000000000101     10001         111111111111111
1000000000000000001000000111     10001
11111111111111111111111111       10001
           11001001001      111111101111111
          11000100101       100001000100001
           110000011        100000000000001
            111111          100001000100001
            1001            100001000100001
            1001            111111000111111
            1111            100001000100001
                            100000000000001
                            100001000100001
                            111111000111111
                            100000000000001
                            1000000N0000001
                            100000000000001
                            111111111111111